B B B B B B B B B B B B F B B B B B B B B B B B F B B B B B B B B B B B B
B B B B B B B B B B B B S B B S S S F S S S B B S B B B B B B B B B B B B
B B F F F F U F F F F F F B B F S S S S S F B B F F F F F F U F F F F B B
B B F S B B B B B B S F S B B B B S F S B B B B S F S B B B B B B S F B B
B B S F B B B B B B F S F S F S F S F S F S F S F S F B B B B B B F S B B
B B F S B B B B B B S F B B B B B S F S B B B B B F S B B B B B B S F B B
B B F F F F F F F F F F B B B B B S S S B B B B B F F F F F F F F F F B B
B B F B B B S S B B B F S F S F S F F F S F S F S F B B B S S B B B F B B
B B F B B B S S B B B F S S F S S S S S S S F S S F B B B S S B B B F B B
B B F B B B S S B B B F B S S S B S F S B S S S B F B B B S S B B B F B B
B B U F F F F L F F F F B S 1 S B S S S B S 2 S B F F F F L F F F F U B B
B B F B B B S S B B B F B B B B B S F S B B B B B F B B B S S B B B F B B
B B F B B B S S B B B F S F S F S S S S S F S F S F B B B S S B B B F B B
B B F B B B S S B B B S F S F S F S P S F S F S F S B B B S S B B B F B B
B B F F F F F F F F F F B B B B B S S S B B B B B F F F F F F F F F F B B
B B F S B B B B B B S F B B B B B S F S B B B B B F S B B B B B B S F B B
B B S F B B B B B B F S F S F S F S F S F S F S F S F B B B B B B F S B B
B B F S B B B B B B S F S B B B B S F S B B B B S F S B B B B B B S F B B
B B F F F F U F F F F F F B B F S S S S S F B B F F F F F F U F F F F B B
B B B B B B B B B B B B S B B S S S F S S S B B S B B B B B B B B B B B B 
B B B B B B B B B B B B F B B B B B B B B B B B F B B B B B B B B B B B B
