B B B B B B B B B B B B S S B B B B B B B B B S S B B B B B B B B B B B B
B S S S S S S S S S S S S S B S S S S S S S B S S S S S S S S S S S S S B
B S S S S S U S S S S S S S S S B S L S B S S S S S S S S S U S S S S S B
B B S S B B B B B B S S S S S B B S 3 S B B S S S S S B B B B B B S S B B
S S S S B B B B B B S S B B S S S S S S S S S B B S S B B B B B B S S S S
S S S S S S S S S S S S B B B B B S S S B B B B B S S S S S S S S S S S S
B B S S S S S S S S S S B B B B B S S S B B B B B S S S S S S S S S S B B
B B S S B B S S B B S S S S S S S S S S S S S S S S S B B S S B B S S B B
B B S S 1 B S S B S S S B B S B B S S S B B S B B S S S B S S B 2 S S B B
B B S S S S S S S S S S B B S B B S S S B B S B B S S S S S S S S S S B B
B B U S S B S L B S S S S S U S S S B S S S U S S S S S B L S B S S U B B
B B S S S S S S S S S S B B S B B S S S B B S B B S S S S S S S S S S B B
B B S S S B S S B S S S B B S B B S S S B B S B B S S S B S S B S S S B B
B B S S B B S S B B S S S S S S S S P S S S S S S S S B B S S B B S S B B
B B S S S S S S S S S S B B B B B S S S B B B B B S S S S S S S S S S B B
S S S S S S S S S S S S B B B B B S S S B B B B B S S S S S S S S S S S S
S S S S B S S S B B S S S S S S S S S S S S S S S S S B B S S S B S S S S
B B S S B B S S S B S S S S S B B S S S B B S S S S S B S S S B B S S B B
B S S S S S U S S S S S S S S S B S S S B S S S S S S S S S U S S S S S B
B S S S S S S S S S B B S S B S S S S S S S B S S B B S S S S S S S S S B 
B B B B B B B B B B B B S S B B B B B B B B B S S B B B B B B B B B B B B
