B B B B B B B B B B B B B B B B B B B B B B B B B B B B B B B B B B B B B
B B B B B B B B B B B B B B B B B B B B B B B B B B B B B B B B B B B B B 
B B B B B B B B B B B B B B B B B B B B B B B B B B B B B B B B B B B B B  
B B B B B B B B B B B B B B B B B B B B B B B B B B B B B B B B B B B B B  
B B B B B B B B B B B B B B B B B B B B B B B B B B B B B B B B B B B B B  
B B B B B B B B B B B B B B B B B B B B B B B B B B B B B B B B B B B B B  
B B B B B B B B B B B B B B B B B B B B B B B B B B B B B B B B B B B B B  
B B B B B B B B B B B B B B B B B B B B B B B B B B B B B B B B B B B B B  
B B B B B B B B B B B B B B B B B B B B B B B B B B B B B B B B B B B B B  
B B B B B B B B B B B B B B B B B B B B B B B B B B B B B B B B B B B B B  
B B B B B B B B B B B B B B B B B B B B B B B B B B B B B B B B B B B B B  
B B B B B B B B B B B B B B B B B B B B B B B B B B B B B B B B B B B B B  
B B B B B B B B B B B B B B B B B B B B B B B B B B B B B B B B B B B B B  
B B B B B B B B B B B B B B B B B B B B B B B B B B B B B B B B B B B B B  
B B B B B B B B B B B B B B B B B B B B B B B B B B B B B B B B B B B B B  
B B F F F B B B B B B B B B B B B B B B B B B B B B B B B B B B F F F B B  
B B F 1 F B B B B B S S S S S S S S P S S S S S S S S B B B B B F 2 F B B  
B B F F F B B B B B B B B B B B B B B B B B B B B B B B B B B B F F F B B  
B B B B B B B B B B B B B B B B B B B B B B B B B B B B B B B B B B B B B  
B B B B B B B B B B B B B B B B B B B B B B B B B B B B B B B B B B B B B 
B B B B B B B B B B B B B B B B B B B B B B B B B B B B B B B B B B B B B
