B B B B B B B B B B B B S S B B B B B B B B B S S B B B B B B B B B B B B
B B B B B B B B B B B B S S B S S S S S S S B S S B B B B B B B B B B B B
B S S S S S S S S S S S S S B S S S S S S S B S S S S S S S S S S S S S B
B S S S S S U S S S S S S S B B B S S S B B B S S S S S S S U S S S S S B
B S S 1 B B B B B B S S S S S S S S S S S S S S S S S B B B B B B 2 S S B
B S S S B B B B B B S S S S S S S S S S S S S S S S S B B B B B B S S S B
B S S S S S S S S S S S B B B B B S S S B B B B B S S S S S S S S S S S B
B S S S S S S S S S S S B B B B B S S S B B B B B S S S S S S S S S S S B
B S S S B S S S S B S S S S S S S S S S S S S S S S S B S S S S B S S S B
B S S S B S S S S B S S B B S S S S S S S S S B B S S B S S S S B S S S B
B U S S B S S L S B S S B B S S S S S S S S S B B S S B S L S S B S S U B
B S S S B S S S S B S S S S S B B S S S B B S S S S S B S S S S B S S S B
B S S S B S S S S B S S S S S B B S S S B B S S S S S B S S S S B S S S B
B S S S B S S S S B S S S S S S S S S S S S S S S S S B S S S S B S S S B
B S S S S S S S S S S S B B B B B S S S B B B B B S S S S S S S S S S S B
B S S S S S S S S S S S B B B B B S S S B B B B B S S S S S S S S S S S B
B S S S B B B B B B S S S S S S S S P S S S S S S S S B B B B B B S S S B
B S S S B B B B B B S S S S B B B S S S B B B S S S S B B B B B B S S S B
B S S S S S U S S S S S S S B S S S S S S S B S S S S S S S U S S S S S B
B B B B B B B B B B B B S S B S S S S S S S B S S B B B B B B B B B B B B 
B B B B B B B B B B B B S S B B B B B B B B B S S B B B B B B B B B B B B
